REICPT=RECEIPT
DEPT=DEPARTMENT
MNG=MANAGER
MN=MAIN
STK=STOCK
BLK=BLOCK
CUST=CUSTOMER
RET=RETURN
DET=DETAIL
SCHE=SCHEDULE
DISTBTOR=DISTRIBUTOR
EMP=EMPLOYEE
CAT=CATEGORY
CST=COST
TYP=TYPE
PRD=PRODUCT
MST=MASTER
TRANS=TRANSACTION
CTRY=COUNTRY
SUP=SUPPLIER
PROMO=PROMOTION
PO=PURCHASE_ORDER
CTRY=COUNTRY
PKGR=PACKAGER
WRKG=WORKING
TMP=TEMP
SIM=SIMILAR
STAT=STATUS
DEF=DEFINITION
USR=USER
PRMTN=PROMOTION
HIS=HISTORY
CRL=
